WWWWWW
WEEEEW
WEEGEW
WEEEEW
WEEEEW
WWWWWW

WWWWWW
WEEEEW
WEEGEW
WEEEEW
WEEEEW
WWWWWW

WWWWWW
WKKKKW
WEEGEW
WEEEEW
WAAAAW
WWWWWW
