WWWWWW
WEEEEW
WEWGEW
WEEEWW
WEEEEW
WWWWWW

WWWWWW
WEEEEW
WEWGEW
WEEEWW
WEEEEW
WWWWWW
