WWWWWW
WEEEEW
WEWEGW
WEEEWW
WEEEEW
WWWWWW

WWWWWW
WEEEEW
WEWEGW
WEEEWW
WEEEEW
WWWWWW
