WWWWWW
WKWWWW
WEDDGW
WKWWWW
WWWWWW

WWWWWW
W_WWWW
WE__GW
W_WWWW
WWWWWW
