WWWWWW
WEWWWW
WEDDGW
WEWWWW
WWWWWW

WWWWWW
W_WWWW
WE__GW
W_WWWW
WWWWWW

WWWWWW
WKWWWW
WADDGW
WKWWWW
WWWWWW
