WWWWWW
WEEEEW
WEWEGW
WEWWWW
WEEEEW
WWWWWW

WWWWWW
WEEEEW
WEWEGW
WEWWWW
WEEEEW
WWWWWW
