WWWWW
WEEEW
WEGEW
WEEEW
WWWWW

WWWWW
WEEEW
WEGEW
WEEEW
WWWWW
