WWWWW
WEEGW
WEEEW
WEEEW
WWWWW

WWWWW
WEEGW
WEEEW
WEEEW
WWWWW
