WWWWW
WEEEW
WEEGW
WEEEW
WWWWW

WWWWW
WEEEW
WEEGW
WEEEW
WWWWW
