WWWWWW
WEEEEW
WEEGEW
WEEEEW
WWEEEW
WWWWWW

WWWWWW
WEEEEW
WEEGEW
WEEEEW
WWEEEW
WWWWWW
