WWWWWW
WEGEEW
WEEEEW
WEEEWW
WEEWWW
WWWWWW

WWWWWW
WEGEEW
WEEEEW
WEEEWW
WEEWWW
WWWWWW
