WWWWWW
WEGEEW
WEEEEW
WEEEEW
WEEEEW
WWWWWW

WWWWWW
WEGEEW
WEEEEW
WEEEEW
WEEEEW
WWWWWW
