WWWWWW
WEWEEW
WEEEWW
WEEEEW
WEGEEW
WWWWWW

WWWWWW
WEWEEW
WEEEWW
WEEEEW
WEGEEW
WWWWWW
