WWWWWWW
WEEEEEW
WEEGEEW
WEEEEEW
WEEWWEW
WWEEEEW
WWWWWWW

WWWWWWW
WEEEEEW
WEEGEEW
WEEEEEW
WEEWWEW
WWEEEEW
WWWWWWW
