WWWWWWW
WEGEEEW
WEWWDWW
WWWEEWW
WEEWEEW
WKWWWEW
WWWWWWW

WWWWWWW
WEGEEEW
WEWWBWW
WWWEEWW
WEEWEEW
WBWWWEW
WWWWWWW
