WWWWWWW
WEGEEEW
WEEEEEW
WWEEEWW
WEEWEEW
WEWWWEW
WWWWWWW

WWWWWWW
WEGEEEW
WEEEEEW
WWEEEWW
WEEWEEW
WEWWWEW
WWWWWWW
