WWWWWWW
WEEEEEW
WGWWDWW
WWEEEWW
WEEWEEW
WKWWWEW
WWWWWWW

WWWWWWW
WEEEEEW
WGWWRWW
WWEEEWW
WEEWEEW
WRWWWEW
WWWWWWW
