WWWWWWW
WEWEWEW
WEEEEEW
WEEEWEW
WEEEWEW
WEGEEEW
WWWWWWW

WWWWWWW
WEWEWEW
WEEEEEW
WEEEWEW
WEEEWEW
WEGEEEW
WWWWWWW
