WWWWWWW
WGWEWEW
WEWEWDW
WEEEWEW
WWWWWEW
WKEEEEW
WWWWWWW

WWWWWWW
WGWEWEW
WEWEWPW
WEEEWEW
WWWWWEW
WPEEEEW
WWWWWWW
