WWWWWWW
WGWEEEW
WEWEWDW
WEEEWEW
WWWWWEW
WKEEEEW
WWWWWWW

WWWWWWW
WGWEEEW
WEWEWRW
WEEEWEW
WWWWWEW
WREEEEW
WWWWWWW
