WWWWWWW
WEEEEEW
WEEEGEW
WEEWEEW
WEEEEEW
WWEEEEW
WWWWWWW

WWWWWWW
WEEEEEW
WEEEGEW
WEEWEEW
WEEEEEW
WWEEEEW
WWWWWWW
