WWWWWWW
WEEEEEW
WEEWGEW
WEEWWWW
WEEWKEW
WWEDEEW
WWWWWWW

WWWWWWW
WEEEEEW
WEEWGEW
WEEWWWW
WEEWBEW
WWEBEEW
WWWWWWW
