WWWWWWW
WEEEEEW
WEEEGEW
WEEEEEW
WEEEEEW
WWEEEWW
WWWWWWW

WWWWWWW
WEEEEEW
WEEEGEW
WEEEEEW
WEEEEEW
WWEEEWW
WWWWWWW
