WWWWWWW
WEEEEWW
WEEEEEW
WEEEWEW
WEEGWEW
WEEEEEW
WWWWWWW

WWWWWWW
WEEEEWW
WEEEEEW
WEEEWEW
WEEGWEW
WEEEEEW
WWWWWWW
