WWWWWWW
WKEEEWW
WEEEEEW
WEWWWEW
WEWGWEW
WEDEWEW
WWWWWWW

WWWWWWW
WREEEWW
WEEEEEW
WEWWWEW
WEWGWEW
WEREWEW
WWWWWWW
