WWWWWWW
WEEEGEW
WDWWWWW
WEWKEEW
WEEWEWW
WWEEEEW
WWWWWWW

WWWWWWW
WEEEGEW
WYWWWWW
WEWYEEW
WEEWEWW
WWEEEEW
WWWWWWW
