WWWWWWW
WEEEGEW
WWEEEEW
WEWEEEW
WEEWEWW
WWEEEEW
WWWWWWW

WWWWWWW
WEEEGEW
WWEEEEW
WEWEEEW
WEEWEWW
WWEEEEW
WWWWWWW
