WWWWWWW
WEEEGEW
WDWWWWW
WEWKEEW
WEEWEWW
WWEEEEW
WWWWWWW

WWWWWWW
WEEEGEW
WGWWWWW
WEWGEEW
WEEWEWW
WWEEEEW
WWWWWWW
