WWWWWWW
WEEEEEW
WEEGEEW
WEEEEEW
WWWWWDW
WWKEEEW
WWWWWWW

WWWWWWW
WEEEEEW
WEEGEEW
WEEEEEW
WWWWWYW
WWYEEEW
WWWWWWW
