WWWWWWWW
WEWEEEEW
WEWEEEEW
WEWEEEEW
WEEEEGEW
WEWWEEEW
WEEEEEEW
WWWWWWWW

WWWWWWWW
WEWEEEEW
WEWEEEEW
WEWEEEEW
WEEEEGEW
WEWWEEEW
WEEEEEEW
WWWWWWWW
