WWWWWWWWW
WEEEWEEEW
WEEEDEEEW
WEEEWEEEW
WEEEDEEEW
WEEEWEEEW
WWWWWWWWW

WWWWWWWWW
WEEEWEEEW
WEEE_EEEW
WEEEWEEEW
WEEE_EEEW
WEEEWEEEW
WWWWWWWWW

WWWWWWWWW
WBBBWGGGW
WBBBDGGGW
WBBBWGGGW
WBBBDGGGW
WBBBWGGGW
WWWWWWWWW
