WWWWWWWWWWWWW
WEEEEEWEEEEEW
WEEEEEDEEEEEW
WEEEEEWEEEEEW
WEEEEEDEEEEEW
WEEEEEWEEEEEW
WWWWWWWWWWWWW

WWWWWWWWWWWWW
WEEEEEWEEEEEW
WEEEEE_EEEEEW
WEEEEEWEEEEEW
WEEEEE_EEEEEW
WEEEEEWEEEEEW
WWWWWWWWWWWWW

WWWWWWWWWWWWW
WBBBBBWGGGGGW
WBBBBBDGGGGGW
WBBBBBWGGGGGW
WBBBBBDGGGGGW
WBBBBBWGGGGGW
WWWWWWWWWWWWW
