WWWWWWWWW
WEEWWWEEW
WEEDEDEEW
WEEWWWEEW
WEEEWEEEW
WEEEWEEEW
WWWWWWWWW

WWWWWWWWW
WEEWWWEEW
WEE_E_EEW
WEEWWWEEW
WEEEWEEEW
WEEEWEEEW
WWWWWWWWW

WWWWWWWWW
WBBWWWGGW
WBBDEDGGW
WBBWWWGGW
WBBBWGGGW
WBBBWGGGW
WWWWWWWWW
