WWWWWW
WEEEEW
WEEEEW
WEEEEW
WWWEEW
WEEEEW
WEEEEW
WEEEEW
WEEWWW
WEEEEW
WEEEEW
WEEEGW
WWWWWW

WWWWWW
WEEEEW
WEEEEW
WEEEEW
WWWEEW
WEEEEW
WEEEEW
WEEEEW
WEEWWW
WEEEEW
WEEEEW
WEEEGW
WWWWWW
