WWWWWW
WEEWWW
WEKDGW
WEEWWW
WWWWWW

WWWWWW
WEEWWW
WERRGW
WEEWWW
WWWWWW
