WWWWWW
WEKDGW
WWWWWW

WWWWWW
WERRGW
WWWWWW
