WWWWWWWWW
WEEWWWEEW
WEEEEEEEW
WEEWWWEEW
WEEEWEEEW
WEEEWEEEW
WWWWWWWWW

WWWWWWWWW
WEEWWWEEW
WEEEEEEEW
WEEWWWEEW
WEEEWEEEW
WEEEWEEEW
WWWWWWWWW

WWWWWWWWW
WAAWWWGGW
WAAAAAGGW
WAAWWWGGW
WAAAWGGGW
WAAAWGGGW
WWWWWWWWW
