WWWWW
WEEEW
WEEEW
WEEGW
WWWWW

WWWWW
WEEEW
WEEEW
WEEGW
WWWWW
