WWWWW
WEEEW
WWWEW
WGEEW
WWWWW

WWWWW
WEEEW
WWWEW
WGEEW
WWWWW
