WWWWW
WEEEW
WWEEW
WGEEW
WWWWW

WWWWW
WEEEW
WWEEW
WGEEW
WWWWW
