WWWWW
WEEEW
WWWEW
WEEEW
WEWWW
WEEGW
WWWWW

WWWWW
WEEEW
WWWEW
WEEEW
WEWWW
WEEGW
WWWWW
