WWWWWWW
WEEEEEW
WEEEEEW
WEEEEEW
WEEEGEW
WEEEEEW
WWWWWWW

WWWWWWW
WEEEEEW
WEEEEEW
WEEEEEW
WEEEGEW
WEEEEEW
WWWWWWW
