WWWWWW
WEEEEW
WWEWWW
WEEWGW
WWEEEW
WWWWWW

WWWWWW
WEEEEW
WWEWWW
WEEWGW
WWEEEW
WWWWWW
