WWWWWWWWWW
WEEEEEEEEW
WEEEEEEWDW
WEEEELLWDW
WKEEEEKWGW
WWWWWWWWWW

WWWWWWWWWW
WEEEEEEEEW
WEEEEEEWBW
WEEEELLWRW
WBEEEERWGW
WWWWWWWWWW
